######
#B## #
  #  #
 ## ##
  # ##
#   ##
## ###
#A   #