######
##   #
#  # #
#B## #
# #  #
#A  ##
######
